AAAAAAAAAAA~~AAAAAAAAA~A
AAAAAA$$$$$~~nnnAnnn~~$A
AAAA$$$_$$$==$$$$$$$~$$A
AAA$$_$$$$$~~$$$$=~~$$$A
AA$$$$$$$~~~~$$$~$A$$$$A
AAA$$A$$~~~~$$$~~$A$$$$A
A$_$$A$$~~$$$~~$$$~$$$$n
AA$$_$$$~~~~~$$$$~$$$$$n
AA$$$$$$~~$$$~=~~$$$$$$n
AAnn$$$~~$$$$$$A$$n$A$$_
~~~~~~~~$$$A$$$A$$n$AA$_
AAAnn$$$$$$$n$$An$$$AA$_
AAA$$n$A$An$$$nAA$$$$AA_
AAA$$$n$A$$$$$$n$$$$$AA_
AAAA$$$$$n$$$$$$$$$$$AA_
AAAAAAAAAAAAAAA$$$$$$nA_