$$$$$$$$$$$$$$$$$$$$$$$$
$$$$$$$$$$$$$$$$$$$$$$$$
~$$$___$$__$__$$_$$$$$$$
~____$$_________$_$$$$$~
~~______$__n_______$$$~~
~~________________$$$~~~
~~_________$________$$~~
~~___________________~~~
~~~____________n_____~~~
~~_____n____________~~~~
~~~~~~______________~~~~
~~~~~~~~~___________~~~~
~~~~~~~~~~__________~~~~
~~~~~~~~~~~~~_______~~~~
~~~~~~~~~~~~~~~~___~~~~~
~~~~~~~~~~~~~~~~~~~~~~~~