________________________
________________________
________________________
________________________
___________$_$__________
______~~~~$$$$$$________
____~~~~~~~$$$_$$_$_____
_____~~~~~~~$__$$_______
______~~~~~$$$______n___
___________~~~____$_____
______________~_________
_______________~________
________________~~______
__________________~___~~
_________________~~~~~~~
________________~~~~~~~~