______________________~~
_________n_____________~
________________________
________________________
________________________
________________________
________________________
________________________
________________________
$$____$_________________
$$$________________$____
$$$$____________________
$$$$$$__________________
$$$$$$$$________________
$$$$$$$$$$$$____________
$$$$$$$$$$$$$$$_________