_________________~~~~~~~
________________~~~~~~~~
_____________________~~~
______________________~~
_______________$______~~
_______________________~
___n___________________~
________________________
________________________
_______________________~
_______________________~
_______________________~
_______$$______________~
_______________________~
_______________________~
______________________~~