AAAAnnnn$_______________
AAAnnn$$________________
AAnn$$$_________________
AAnn$$$_________________
AAnn$$$_________________
Ann$____________________
nn$$$___________________
$$__________________$___
________________________
________________________
________$_______________
________________________
________________________
________________________
_______________n________
________________________