~~~~~~~~~~~~~~~~~~~~~~~~
~~________~~~~~~~$nn$~~~
~____$$_$_____~~$$$nn$~~
~__$$$$$n$$$___~$$$An$~~
~~~~~$$$$$n$$_~~$$nn$_~~
~~~~~~~$$$$$$__~~nA$$_~~
~__~~~~A$$$$$__~~nn$$_~~
__$_____~~~____~~$n$_~~~
__$_____~~~~~~~~$nn$$_~~
~__nA$_________~$n$$$_~~
~____nnnnA_____~nn$$$$~~
~~____$$nn___n__A$$$n$~~
~~~_____________$A$n$$~~
~~~___________~~~~~$$~~~
~~~~~________~~~~~~~~~~~
~~~~~~~~~~~~~~~~~~~~~~~~