________________________
________________^^^_____
_______^________^^^_____
________________________
________________________
____~~~~~~===~~~~~~~~~__
__~~~~~~~~===~~~~~~~~~~~
~~~~~~~~________~~~~~~~~
~~~~~~~___________~~~~~~
~~~~____________________
________________________
________________________
________^^______________
________________^^______
________________________
________________________